"Date","ANTIOQUIA_CHOCO","CENTRO","EJE_CAFETERO","NORTE","OCCIDENTE","Total"
2017-01-01,305,197,56,88,74,720
2017-01-02,452,318,101,124,171,1166
2017-01-03,406,296,93,148,139,1082
2017-01-04,335,260,81,131,123,930
2017-01-05,360,265,118,113,141,997
2017-01-06,480,327,129,150,163,1249
2017-01-07,518,374,131,197,163,1383
2017-01-08,401,256,106,131,115,1009
2017-01-09,329,237,83,97,89,835
2017-01-10,497,342,88,138,167,1232
2017-01-11,460,330,73,116,120,1099
2017-01-12,444,312,73,96,119,1044
2017-01-13,605,439,107,103,184,1438
2017-01-14,800,514,95,141,195,1745
2017-01-15,288,198,56,90,84,716
2017-01-16,463,262,55,125,119,1024
2017-01-17,406,305,65,112,82,970
2017-01-18,381,305,72,91,132,981
2017-01-19,415,319,56,100,137,1027
2017-01-20,638,459,88,128,164,1477
2017-01-21,739,654,90,116,195,1794
2017-01-22,293,228,46,88,115,770
2017-01-23,440,363,75,106,152,1136
2017-01-24,399,299,69,99,132,998
2017-01-25,410,298,79,63,134,984
2017-01-26,418,288,58,77,142,983
2017-01-27,682,497,85,121,217,1602
2017-01-28,790,658,62,118,190,1818
2017-01-29,285,246,35,54,101,721
2017-01-30,386,323,67,107,142,1025
2017-01-31,403,313,53,93,133,995
2017-02-01,372,282,71,101,144,970
2017-02-02,406,206,50,109,155,926
2017-02-03,626,527,67,148,180,1548
2017-02-04,806,659,78,130,223,1896
2017-02-05,301,220,46,62,102,731
2017-02-06,393,329,80,117,161,1080
2017-02-07,374,298,58,92,137,959
2017-02-08,323,393,52,95,121,984
2017-02-09,378,329,68,102,123,1000
2017-02-10,698,540,68,95,187,1588
2017-02-11,863,664,79,117,216,1939
2017-02-12,272,221,58,82,95,728
2017-02-13,374,272,45,86,128,905
2017-02-14,405,263,65,105,112,950
2017-02-15,349,260,64,93,108,874
2017-02-16,421,306,67,91,147,1032
2017-02-17,644,492,75,119,193,1523
2017-02-18,928,696,79,144,212,2059
2017-02-19,323,257,69,62,95,806
2017-02-20,481,294,69,99,123,1066
2017-02-21,470,265,53,113,145,1046
2017-02-22,432,286,69,106,131,1024
2017-02-23,466,289,77,82,94,1008
2017-02-24,714,502,58,121,167,1562
2017-02-25,884,703,89,127,232,2035
2017-02-26,368,228,54,89,79,818
2017-02-27,435,300,48,98,130,1011
2017-02-28,394,347,66,103,125,1035
2017-03-01,457,287,55,115,116,1030
2017-03-02,476,309,56,83,130,1054
2017-03-03,630,511,55,143,171,1510
2017-03-04,855,676,68,146,217,1962
2017-03-05,288,175,35,68,84,650
2017-03-06,380,288,63,90,133,954
2017-03-07,347,360,68,78,133,986
2017-03-08,443,348,63,79,131,1064
2017-03-09,404,282,55,95,120,956
2017-03-10,646,517,78,144,194,1579
2017-03-11,938,694,77,114,225,2048
2017-03-12,331,221,59,71,80,762
2017-03-13,378,311,83,96,133,1001
2017-03-14,435,287,41,92,113,968
2017-03-15,422,299,57,82,118,978
2017-03-16,408,325,66,76,152,1027
2017-03-17,604,502,84,134,190,1514
2017-03-18,829,632,113,151,231,1956
2017-03-19,488,353,71,103,118,1133
2017-03-20,333,254,91,56,102,836
2017-03-21,406,402,91,102,164,1165
2017-03-22,353,278,55,78,173,937
2017-03-23,301,400,57,103,143,1004
2017-03-24,522,514,79,109,168,1392
2017-03-25,904,742,93,119,217,2075
2017-03-26,309,239,54,46,62,710
2017-03-27,361,373,83,83,128,1028
2017-03-28,419,335,73,90,119,1036
2017-03-29,338,325,64,79,137,943
2017-03-30,483,274,77,92,133,1059
2017-03-31,726,591,103,151,217,1788
2017-04-01,908,625,109,151,274,2067
2017-04-02,331,179,58,69,101,738
2017-04-03,450,291,71,91,177,1080
2017-04-04,374,282,57,92,146,951
2017-04-05,413,279,44,110,136,982
2017-04-06,411,321,57,85,139,1013
2017-04-07,702,524,88,125,203,1642
2017-04-08,837,615,112,138,241,1943
2017-04-09,342,229,76,78,118,843
2017-04-10,431,310,89,99,105,1034
2017-04-11,383,240,80,104,127,934
2017-04-12,589,347,90,130,150,1306
2017-04-13,320,219,80,97,80,796
2017-04-14,248,172,69,77,95,661
2017-04-15,495,330,115,120,135,1195
2017-04-16,348,215,83,84,125,855
2017-04-17,445,368,90,99,195,1197
2017-04-18,375,333,59,91,138,996
2017-04-19,338,260,60,80,129,867
2017-04-20,417,282,87,74,156,1016
2017-04-21,410,464,78,116,185,1253
2017-04-22,993,679,109,116,234,2131
2017-04-23,298,236,53,60,75,722
2017-04-24,411,316,73,87,117,1004
2017-04-25,290,228,34,64,73,689
2017-04-26,485,353,77,106,120,1141
2017-04-27,429,266,68,103,141,1007
2017-04-28,673,505,79,134,180,1571
2017-04-29,852,633,81,151,214,1931
2017-04-30,532,312,71,105,132,1152
2017-05-01,291,238,69,64,92,754
2017-05-02,520,379,79,124,148,1250
2017-05-03,368,340,56,105,137,1006
2017-05-04,400,323,65,100,141,1029
2017-05-05,612,488,85,108,213,1506
2017-05-06,911,645,96,136,216,2004
2017-05-07,308,229,27,75,81,720
2017-05-08,465,282,55,110,155,1067
2017-05-09,370,273,74,79,129,925
2017-05-10,404,259,64,100,139,966
2017-05-11,407,320,67,100,138,1032
2017-05-12,628,504,83,135,208,1558
2017-05-13,936,698,85,128,280,2127
2017-05-14,353,330,64,89,115,951
2017-05-15,450,393,81,122,147,1193
2017-05-16,392,305,64,120,126,1007
2017-05-17,425,296,63,88,153,1025
2017-05-18,429,332,83,97,120,1061
2017-05-19,708,508,81,118,230,1645
2017-05-20,874,766,80,137,197,2054
2017-05-21,306,243,34,56,96,735
2017-05-22,446,305,63,109,119,1042
2017-05-23,489,272,68,103,126,1058
2017-05-24,407,273,61,91,137,969
2017-05-25,481,349,74,105,133,1142
2017-05-26,675,503,78,122,210,1588
2017-05-27,855,625,109,140,226,1955
2017-05-28,449,357,77,114,132,1129
2017-05-29,347,198,82,78,82,787
2017-05-30,532,305,70,107,160,1174
2017-05-31,386,297,59,91,118,951
2017-06-01,444,331,74,102,143,1094
2017-06-02,682,494,67,148,175,1566
2017-06-03,948,743,105,140,212,2148
2017-06-04,312,193,29,54,112,700
2017-06-05,410,327,56,103,133,1029
2017-06-06,419,261,77,100,110,967
2017-06-07,479,352,62,106,145,1144
2017-06-08,483,296,59,104,155,1097
2017-06-09,714,505,80,119,182,1600
2017-06-10,940,686,85,136,247,2094
2017-06-11,350,215,59,86,102,812
2017-06-12,471,337,73,113,141,1135
2017-06-13,374,322,40,96,147,979
2017-06-14,455,273,54,77,148,1007
2017-06-15,444,312,71,99,162,1088
2017-06-16,718,517,86,115,256,1692
2017-06-17,882,638,129,148,253,2050
2017-06-18,613,399,63,138,125,1338
2017-06-19,368,212,78,74,75,807
2017-06-20,492,296,84,132,131,1135
2017-06-21,430,284,81,93,140,1028
2017-06-22,422,331,63,84,121,1021
2017-06-23,645,448,113,99,184,1489
2017-06-24,749,577,94,146,246,1812
2017-06-25,468,345,90,109,128,1140
2017-06-26,339,198,60,97,81,775
2017-06-27,531,334,86,135,145,1231
2017-06-28,433,288,69,93,127,1010
2017-06-29,436,301,75,93,125,1030
2017-06-30,652,454,108,135,197,1546
2017-07-01,785,532,144,187,247,1895
2017-07-02,496,327,114,113,120,1170
2017-07-03,326,203,77,79,110,795
2017-07-04,501,357,67,131,144,1200
2017-07-05,445,282,46,100,122,995
2017-07-06,341,278,59,98,128,904
2017-07-07,674,533,86,107,204,1604
2017-07-08,915,641,114,143,207,2020
2017-07-09,351,198,62,71,88,770
2017-07-10,449,324,69,113,123,1078
2017-07-11,428,287,79,89,115,998
2017-07-12,384,307,57,131,114,993
2017-07-13,395,314,56,132,133,1030
2017-07-14,693,512,75,127,193,1600
2017-07-15,862,645,95,146,252,2000
2017-07-16,360,242,65,61,127,855
2017-07-17,460,294,78,119,141,1092
2017-07-18,424,277,65,109,148,1023
2017-07-19,693,463,87,124,188,1555
2017-07-20,332,205,57,75,95,764
2017-07-21,737,402,97,140,169,1545
2017-07-22,729,550,102,144,188,1713
2017-07-23,288,217,45,84,95,729
2017-07-24,462,307,65,119,131,1084
2017-07-25,441,284,64,88,109,986
2017-07-26,462,271,66,95,124,1018
2017-07-27,463,299,60,105,130,1057
2017-07-28,768,521,58,139,166,1652
2017-07-29,887,651,81,128,224,1971
2017-07-30,310,213,68,66,90,747
2017-07-31,489,365,88,145,128,1215
2017-08-01,482,261,57,111,127,1038
2017-08-02,440,268,50,100,110,968
2017-08-03,527,291,85,101,136,1140
2017-08-04,736,574,91,148,176,1725
2017-08-05,836,605,102,149,229,1921
2017-08-06,590,382,69,109,125,1275
2017-08-07,396,181,56,68,90,791
2017-08-08,531,338,67,139,166,1241
2017-08-09,426,317,67,88,126,1024
2017-08-10,472,302,64,90,137,1065
2017-08-11,590,454,91,116,205,1456
2017-08-12,853,667,99,133,207,1959
2017-08-13,283,212,56,86,100,737
2017-08-14,509,303,63,94,164,1133
2017-08-15,417,304,57,107,110,995
2017-08-16,418,239,61,77,102,897
2017-08-17,450,320,67,92,117,1046
2017-08-18,701,492,77,138,226,1634
2017-08-19,787,642,114,146,237,1926
2017-08-20,526,346,87,119,139,1217
2017-08-21,349,256,84,60,86,835
2017-08-22,424,331,74,122,163,1114
2017-08-23,455,283,52,108,143,1041
2017-08-24,499,317,52,108,131,1107
2017-08-25,658,477,99,109,190,1533
2017-08-26,982,644,111,156,262,2155
2017-08-27,316,237,59,70,90,772
2017-08-28,487,321,57,102,122,1089
2017-08-29,409,312,71,116,126,1034
2017-08-30,358,294,62,100,130,944
2017-08-31,507,379,65,125,114,1190
2017-09-01,720,530,111,128,194,1683
2017-09-02,880,651,90,173,254,2048
2017-09-03,287,218,68,68,114,755
2017-09-04,418,275,58,114,165,1030
2017-09-05,487,294,64,107,115,1067
2017-09-06,390,245,55,121,134,945
2017-09-07,446,180,74,109,152,961
2017-09-08,548,430,61,153,190,1382
2017-09-09,720,679,104,149,236,1888
2017-09-10,289,219,41,64,115,728
2017-09-11,410,299,76,101,145,1031
2017-09-12,426,279,62,122,139,1028
2017-09-13,434,304,44,69,141,992
2017-09-14,458,305,70,94,134,1061
2017-09-15,775,457,66,139,223,1660
2017-09-16,1103,710,124,167,262,2366
2017-09-17,369,250,53,94,114,880
2017-09-18,460,328,71,108,159,1126
2017-09-19,431,235,53,106,129,954
2017-09-20,369,276,57,97,126,925
2017-09-21,423,302,52,82,110,969
2017-09-22,746,445,84,109,195,1579
2017-09-23,1043,754,73,161,246,2277
2017-09-24,290,229,48,73,93,733
2017-09-25,493,302,62,94,156,1107
2017-09-26,375,281,42,111,155,964
2017-09-27,435,295,61,87,135,1013
2017-09-28,392,332,53,133,139,1049
2017-09-29,747,566,84,156,195,1748
2017-09-30,1013,751,111,189,236,2300
2017-10-01,303,237,74,91,84,789
2017-10-02,518,288,65,94,115,1080
2017-10-03,455,297,76,99,126,1053
2017-10-04,398,297,58,96,158,1007
2017-10-05,535,387,76,126,155,1279
2017-10-06,636,426,99,111,203,1475
2017-10-07,856,596,98,148,210,1908
2017-10-08,315,229,46,104,126,820
2017-10-09,443,275,70,87,124,999
2017-10-10,493,389,86,116,139,1223
2017-10-11,332,288,36,136,138,930
2017-10-12,365,280,69,115,136,965
2017-10-13,594,428,100,127,178,1427
2017-10-14,841,525,146,150,211,1873
2017-10-15,529,352,87,126,107,1201
2017-10-16,350,264,82,77,100,873
2017-10-17,476,341,84,114,141,1156
2017-10-18,434,289,58,136,143,1060
2017-10-19,394,361,41,117,160,1073
2017-10-20,717,551,72,120,240,1700
2017-10-21,922,711,94,119,247,2093
2017-10-22,320,199,74,93,92,778
2017-10-23,423,323,69,112,146,1073
2017-10-24,386,274,67,83,108,918
2017-10-25,374,278,62,93,132,939
2017-10-26,433,301,57,130,149,1070
2017-10-27,847,603,97,139,208,1894
2017-10-28,1039,822,103,216,288,2468
2017-10-29,296,289,53,80,99,817
2017-10-30,502,318,67,100,166,1153
2017-10-31,489,306,72,112,96,1075
2017-11-01,469,327,80,112,127,1115
2017-11-02,444,328,79,140,144,1135
2017-11-03,723,567,94,137,188,1709
2017-11-04,942,665,113,166,238,2124
2017-11-05,541,401,66,131,136,1275
2017-11-06,374,201,66,74,97,812
2017-11-07,424,395,88,109,192,1208
2017-11-08,361,278,64,146,130,979
2017-11-09,414,329,75,131,164,1113
2017-11-10,631,439,88,119,175,1452
2017-11-11,900,595,122,163,237,2017
2017-11-12,555,410,72,118,155,1310
2017-11-13,312,243,64,79,112,810
2017-11-14,504,401,64,133,167,1269
2017-11-15,455,314,74,101,154,1098
2017-11-16,512,352,78,126,153,1221
2017-11-17,852,566,89,169,211,1887
2017-11-18,1030,720,99,155,203,2207
2017-11-19,358,256,33,84,108,839
2017-11-20,434,405,53,109,155,1156
2017-11-21,388,350,67,103,138,1046
2017-11-22,452,300,80,99,129,1060
2017-11-23,535,364,78,103,169,1249
2017-11-24,884,681,93,143,220,2021
2017-11-25,1079,798,134,147,289,2447
2017-11-26,314,288,60,75,108,845
2017-11-27,453,338,62,124,159,1136
2017-11-28,492,333,71,94,136,1126
2017-11-29,448,358,64,107,148,1125
2017-11-30,690,461,88,111,147,1497
2017-12-01,1146,712,123,195,262,2438
2017-12-02,1052,824,134,202,335,2547
2017-12-03,400,246,65,97,117,925
2017-12-04,451,368,87,129,162,1197
2017-12-05,507,355,75,144,164,1245
2017-12-06,565,400,64,144,152,1325
2017-12-07,933,636,76,188,239,2072
2017-12-08,792,468,90,154,166,1670
2017-12-09,1014,597,121,150,318,2200
2017-12-10,385,306,59,93,125,968
2017-12-11,515,439,85,132,186,1357
2017-12-12,526,361,75,129,149,1240
2017-12-13,514,382,55,91,169,1211
2017-12-14,652,410,75,136,192,1465
2017-12-15,1092,817,107,211,384,2611
2017-12-16,1127,793,118,196,279,2513
2017-12-17,424,341,87,113,125,1090
2017-12-18,598,364,63,123,207,1355
2017-12-19,614,392,75,155,196,1432
2017-12-20,607,401,82,123,193,1406
2017-12-21,767,499,115,125,223,1729
2017-12-22,1041,650,124,207,304,2326
2017-12-23,876,541,108,178,274,1977
2017-12-24,652,491,91,154,193,1581
2017-12-25,373,318,62,110,159,1022
2017-12-26,569,443,96,155,269,1532
2017-12-27,566,361,97,155,266,1445
2017-12-28,689,361,123,156,308,1637
2017-12-29,883,392,132,196,328,1931
2017-12-30,753,324,151,186,355,1769
2017-12-31,403,252,91,139,171,1056
2018-01-01,369,186,88,110,107,860
2018-01-02,490,355,117,163,180,1305
2018-01-03,462,282,99,146,133,1122
2018-01-04,434,308,99,148,154,1143
2018-01-05,486,336,107,139,181,1249
2018-01-06,528,331,118,164,162,1303
2018-01-07,487,261,99,142,126,1115
2018-01-08,263,214,71,101,107,756
2018-01-09,532,424,82,139,164,1341
2018-01-10,427,290,85,107,104,1013
2018-01-11,468,301,82,120,165,1136
2018-01-12,554,398,94,129,174,1349
2018-01-13,702,488,102,136,184,1612
2018-01-14,306,181,57,78,101,723
2018-01-15,430,364,85,91,165,1135
2018-01-16,437,297,64,114,164,1076
2018-01-17,469,277,68,90,145,1049
2018-01-18,458,280,57,99,144,1038
2018-01-19,628,484,94,119,185,1510
2018-01-20,874,584,87,152,215,1912
2018-01-21,316,197,36,69,84,702
2018-01-22,463,301,65,124,129,1082
2018-01-23,395,295,47,110,130,977
2018-01-24,375,263,70,90,120,918
2018-01-25,444,270,69,132,128,1043
2018-01-26,632,408,77,144,197,1458
2018-01-27,872,582,93,158,226,1931
2018-01-28,330,240,75,92,87,824
2018-01-29,426,323,71,104,138,1062
2018-01-30,422,306,74,142,131,1075
2018-01-31,476,282,62,103,180,1103
2018-02-01,452,169,83,114,146,964
2018-02-02,783,476,62,130,197,1648
2018-02-03,997,628,88,157,243,2113
2018-02-04,360,206,53,93,130,842
2018-02-05,446,286,69,125,193,1119
2018-02-06,411,319,53,101,149,1033
2018-02-07,485,334,69,105,169,1162
2018-02-08,399,315,59,96,142,1011
2018-02-09,627,492,81,141,162,1503
2018-02-10,882,594,95,108,203,1882
2018-02-11,315,201,53,100,81,750
2018-02-12,518,305,67,122,162,1174
2018-02-13,454,259,57,90,148,1008
2018-02-14,453,320,58,121,152,1104
2018-02-15,477,293,73,92,128,1063
2018-02-16,705,482,112,137,200,1636
2018-02-17,970,625,114,124,258,2091
2018-02-18,302,245,57,72,126,802
2018-02-19,491,337,56,106,151,1141
2018-02-20,396,328,78,98,159,1059
2018-02-21,429,287,61,100,143,1020
2018-02-22,485,316,64,115,150,1130
2018-02-23,692,524,91,136,247,1690
2018-02-24,964,647,90,147,244,2092
2018-02-25,375,190,65,69,118,817
2018-02-26,541,326,66,94,141,1168
2018-02-27,451,342,61,93,157,1104
2018-02-28,437,286,74,113,141,1051
2018-03-01,455,278,69,117,131,1050
2018-03-02,728,451,75,111,214,1579
2018-03-03,1035,646,97,129,263,2170
2018-03-04,343,249,45,70,106,813
2018-03-05,434,295,84,102,141,1056
2018-03-06,455,278,66,124,127,1050
2018-03-07,379,287,58,98,141,963
2018-03-08,405,300,65,122,144,1036
2018-03-09,662,552,90,123,215,1642
2018-03-10,711,516,87,111,228,1653
2018-03-11,401,203,65,66,108,843
2018-03-12,474,305,67,142,136,1124
2018-03-13,421,337,70,136,134,1098
2018-03-14,432,320,62,102,157,1073
2018-03-15,506,360,67,107,151,1191
2018-03-16,754,519,96,135,213,1717
2018-03-17,1014,678,102,170,221,2185
2018-03-18,575,396,74,140,143,1328
2018-03-19,345,254,79,89,114,881
2018-03-20,561,377,79,144,208,1369
2018-03-21,479,322,68,96,147,1112
2018-03-22,374,236,66,100,123,899
2018-03-23,795,597,95,131,194,1812
2018-03-24,861,604,144,136,234,1979
2018-03-25,390,291,52,101,125,959
2018-03-26,475,336,100,113,158,1182
2018-03-27,435,386,87,134,160,1202
2018-03-28,545,403,112,141,156,1357
2018-03-29,335,211,115,140,107,908
2018-03-30,267,150,58,83,73,631
2018-03-31,506,374,146,124,136,1286
2018-04-01,367,312,95,101,120,995
2018-04-02,568,420,107,106,207,1408
2018-04-03,430,343,62,114,162,1111
2018-04-04,443,364,76,101,160,1144
2018-04-05,544,369,69,103,143,1228
2018-04-06,659,500,76,119,204,1558
2018-04-07,1042,666,96,169,248,2221
2018-04-08,373,234,46,72,111,836
2018-04-09,518,357,72,119,171,1237
2018-04-10,470,301,72,94,143,1080
2018-04-11,432,322,77,141,116,1088
2018-04-12,473,364,68,94,128,1127
2018-04-13,720,540,96,112,193,1661
2018-04-14,976,707,101,162,255,2201
2018-04-15,352,216,58,88,111,825
2018-04-16,460,337,74,115,138,1124
2018-04-17,455,287,81,112,163,1098
2018-04-18,362,301,79,91,123,956
2018-04-19,449,292,49,86,173,1049
2018-04-20,699,493,96,164,210,1662
2018-04-21,944,640,86,142,235,2047
2018-04-22,395,224,48,69,106,842
2018-04-23,508,384,89,125,172,1278
2018-04-24,330,332,93,122,146,1023
2018-04-25,449,296,59,118,135,1057
2018-04-26,478,316,89,127,159,1169
2018-04-27,643,488,99,134,233,1597
2018-04-28,883,679,105,198,267,2132
2018-04-29,381,226,66,92,116,881
2018-04-30,637,404,105,134,191,1471
2018-05-01,328,212,43,100,107,790
2018-05-02,482,364,84,143,162,1235
2018-05-03,429,320,66,118,162,1095
2018-05-04,778,477,99,143,218,1715
2018-05-05,987,611,84,162,236,2080
2018-05-06,314,251,63,86,124,838
2018-05-07,441,329,85,137,150,1142
2018-05-08,473,357,52,119,147,1148
2018-05-09,504,341,74,124,152,1195
2018-05-10,493,326,66,123,151,1159
2018-05-11,747,533,81,148,212,1721
2018-05-12,929,690,104,181,176,2080
2018-05-13,603,412,95,109,125,1344
2018-05-14,357,209,64,58,103,791
2018-05-15,667,452,89,129,171,1508
2018-05-16,471,329,72,107,132,1111
2018-05-17,422,322,84,88,146,1062
2018-05-18,735,454,76,142,213,1620
2018-05-19,957,692,92,156,224,2121
2018-05-20,360,231,72,79,115,857
2018-05-21,472,368,73,107,145,1165
2018-05-22,470,311,70,94,152,1097
2018-05-23,503,348,67,121,151,1190
2018-05-24,482,326,72,106,149,1135
2018-05-25,775,544,99,143,254,1815
2018-05-26,725,532,56,158,181,1652
2018-05-27,386,223,49,84,91,833
2018-05-28,486,333,83,124,171,1197
2018-05-29,468,314,76,127,121,1106
2018-05-30,446,288,74,128,155,1091
2018-05-31,451,351,82,119,170,1173
2018-06-01,725,496,115,141,227,1704
2018-06-02,984,653,139,181,245,2202
2018-06-03,584,380,95,136,163,1358
2018-06-04,313,238,61,85,108,805
2018-06-05,571,391,73,138,154,1327
2018-06-06,471,350,92,116,146,1175
2018-06-07,412,317,84,106,140,1059
2018-06-08,679,455,106,158,193,1591
2018-06-09,940,553,129,177,234,2033
2018-06-10,570,373,81,141,112,1277
2018-06-11,311,217,80,89,102,799
2018-06-12,491,371,91,164,194,1311
2018-06-13,521,359,92,91,160,1223
2018-06-14,448,323,74,126,140,1111
2018-06-15,789,526,109,146,221,1791
2018-06-16,697,509,83,123,178,1590
2018-06-17,366,202,54,101,96,819
2018-06-18,465,287,78,127,126,1083
2018-06-19,457,306,83,105,169,1120
2018-06-20,394,279,63,107,143,986
2018-06-21,459,299,79,131,147,1115
2018-06-22,769,443,75,155,248,1690
2018-06-23,968,578,103,168,267,2084
2018-06-24,508,387,67,120,164,1246
2018-06-25,479,351,69,134,156,1189
2018-06-26,470,288,71,106,180,1115
2018-06-27,427,337,80,128,157,1129
2018-06-28,440,332,95,149,159,1175
2018-06-29,673,498,75,140,241,1627
2018-06-30,795,495,144,186,235,1855
2018-07-01,522,319,120,124,145,1230
2018-07-02,389,221,90,126,94,920
2018-07-03,567,389,112,157,163,1388
2018-07-04,476,374,94,115,163,1222
2018-07-05,508,365,66,113,135,1187
2018-07-06,645,428,73,137,207,1490
2018-07-07,800,504,128,168,248,1848
2018-07-08,395,223,70,104,121,913
2018-07-09,442,356,85,118,147,1148
2018-07-10,457,325,55,92,138,1067
2018-07-11,410,254,72,117,144,997
2018-07-12,466,302,86,103,155,1112
2018-07-13,798,458,86,166,232,1740
2018-07-14,989,604,124,150,267,2134
2018-07-15,386,225,56,97,133,897
2018-07-16,487,350,77,120,154,1188
2018-07-17,520,322,49,127,145,1163
2018-07-18,474,299,69,127,162,1131
2018-07-19,756,463,100,165,243,1727
2018-07-20,649,404,116,123,189,1481
2018-07-21,827,460,124,178,220,1809
2018-07-22,365,239,78,83,104,869
2018-07-23,547,316,95,121,158,1237
2018-07-24,422,319,72,109,148,1070
2018-07-25,413,316,76,97,109,1011
2018-07-26,595,328,73,115,164,1275
2018-07-27,795,441,114,193,206,1749
2018-07-28,1053,672,112,193,267,2297
2018-07-29,407,229,62,94,123,915
2018-07-30,491,311,98,120,129,1149
2018-07-31,461,353,67,124,118,1123
2018-08-01,511,353,89,126,152,1231
2018-08-02,527,340,79,124,156,1226
2018-08-03,825,469,81,119,196,1690
2018-08-04,965,642,127,144,263,2141
2018-08-05,350,217,74,77,136,854
2018-08-06,784,389,102,141,155,1571
2018-08-07,392,202,59,76,61,790
2018-08-08,623,378,92,130,155,1378
2018-08-09,541,328,61,135,150,1215
2018-08-10,784,478,84,113,213,1672
2018-08-11,1018,661,111,182,273,2245
2018-08-12,344,223,51,84,109,811
2018-08-13,488,362,79,136,159,1224
2018-08-14,544,290,70,116,150,1170
2018-08-15,537,366,76,89,170,1238
2018-08-16,486,356,62,124,154,1182
2018-08-17,724,490,86,155,216,1671
2018-08-18,901,652,130,190,256,2129
2018-08-19,582,368,79,122,166,1317
2018-08-20,396,279,73,99,123,970
2018-08-21,518,433,92,149,203,1395
2018-08-22,536,401,77,126,158,1298
2018-08-23,501,352,106,119,145,1223
2018-08-24,748,525,105,135,233,1746
2018-08-25,808,540,80,132,226,1786
2018-08-26,324,252,55,66,72,769
2018-08-27,451,349,56,123,135,1114
2018-08-28,484,362,52,105,159,1162
2018-08-29,424,363,76,123,160,1146
2018-08-30,471,357,54,109,134,1125
2018-08-31,792,530,95,196,274,1887
2018-09-01,1065,623,118,172,273,2251
2018-09-02,359,232,69,115,120,895
2018-09-03,483,318,104,143,162,1210
2018-09-04,575,299,67,119,160,1220
2018-09-05,496,322,72,122,174,1186
2018-09-06,490,322,72,112,159,1155
2018-09-07,740,550,78,157,195,1720
2018-09-08,1037,709,95,158,261,2260
2018-09-09,336,249,48,93,148,874
2018-09-10,507,334,73,133,165,1212
2018-09-11,485,340,71,110,160,1166
2018-09-12,648,343,61,135,189,1376
2018-09-13,482,355,93,113,168,1211
2018-09-14,804,561,98,173,277,1913
2018-09-15,1120,770,144,214,308,2556
2018-09-16,362,281,84,100,122,949
2018-09-17,566,397,107,122,150,1342
2018-09-18,576,382,64,128,180,1330
2018-09-19,526,328,83,127,148,1212
2018-09-20,553,379,79,103,156,1270
2018-09-21,837,565,85,168,248,1903
2018-09-22,1072,723,111,206,145,2257
2018-09-23,404,264,69,72,115,924
2018-09-24,460,362,86,129,180,1217
2018-09-25,541,330,56,118,133,1178
2018-09-26,454,308,89,107,164,1122
2018-09-27,603,364,100,130,177,1374
2018-09-28,869,613,95,157,256,1990
2018-09-29,1029,769,144,187,279,2408
2018-09-30,366,302,77,104,111,960
2018-10-01,513,380,79,138,177,1287
2018-10-02,565,357,71,150,217,1360
2018-10-03,563,333,88,141,143,1268
2018-10-04,600,364,87,151,178,1380
2018-10-05,839,536,100,197,234,1906
2018-10-06,1038,696,119,227,249,2329
2018-10-07,387,244,103,101,107,942
2018-10-08,484,353,108,151,170,1266
2018-10-09,517,355,85,132,170,1259
2018-10-10,573,381,60,125,147,1286
2018-10-11,531,360,103,167,145,1306
2018-10-12,734,426,119,158,243,1680
2018-10-13,779,490,147,216,259,1891
2018-10-14,606,313,124,147,159,1349
2018-10-15,417,297,86,96,147,1043
2018-10-16,555,412,68,178,204,1417
2018-10-17,646,392,90,156,167,1451
2018-10-18,541,380,84,152,181,1338
2018-10-19,714,584,75,145,212,1730
2018-10-20,1007,741,107,168,319,2342
2018-10-21,370,239,67,105,109,890
2018-10-22,531,345,110,147,176,1309
2018-10-23,573,314,62,137,164,1250
2018-10-24,464,333,73,127,138,1135
2018-10-25,551,399,94,147,159,1350
2018-10-26,812,537,97,154,254,1854
2018-10-27,1197,792,140,202,303,2634
2018-10-28,404,289,53,94,134,974
2018-10-29,500,397,91,157,159,1304
2018-10-30,573,412,89,135,154,1363
2018-10-31,625,412,100,112,187,1436
2018-11-01,624,402,92,143,157,1418
2018-11-02,813,597,129,171,207,1917
2018-11-03,974,643,112,189,259,2177
2018-11-04,704,412,108,136,172,1532
2018-11-05,376,266,75,71,134,922
2018-11-06,699,445,86,126,195,1551
2018-11-07,606,356,73,135,186,1356
2018-11-08,471,389,91,140,140,1231
2018-11-09,724,499,89,147,219,1678
2018-11-10,850,672,111,209,215,2057
2018-11-11,627,389,83,149,147,1395
2018-11-12,393,253,72,98,84,900
2018-11-13,641,428,99,175,190,1533
2018-11-14,586,450,68,138,172,1414
2018-11-15,543,343,86,135,150,1257
2018-11-16,790,562,94,139,236,1821
2018-11-17,1015,749,117,169,302,2352
2018-11-18,382,273,57,100,132,944
2018-11-19,494,330,87,120,180,1211
2018-11-20,577,322,77,127,159,1262
2018-11-21,472,324,70,132,143,1141
2018-11-22,675,439,82,119,185,1500
2018-11-23,968,634,112,143,222,2079
2018-11-24,1053,776,111,184,292,2416
2018-11-25,452,267,74,95,135,1023
2018-11-26,556,381,84,126,175,1322
2018-11-27,576,444,85,107,179,1391
2018-11-28,588,347,66,140,173,1314
2018-11-29,687,535,79,135,193,1629
2018-11-30,1309,761,134,195,313,2712
2018-12-01,1259,807,129,197,326,2718
2018-12-02,449,307,72,119,112,1059
2018-12-03,557,374,115,175,182,1403
2018-12-04,550,393,84,155,166,1348
2018-12-05,668,314,99,145,182,1408
2018-12-06,755,401,90,159,183,1588
2018-12-07,1121,663,109,228,220,2341
2018-12-08,1097,676,114,159,284,2330
2018-12-09,406,290,93,110,139,1038
2018-12-10,622,418,115,173,179,1507
2018-12-11,637,380,86,145,196,1444
2018-12-12,649,319,76,142,151,1337
2018-12-13,747,484,108,160,215,1714
2018-12-14,1253,724,139,244,398,2758
2018-12-15,1238,785,155,248,373,2799
2018-12-16,492,294,78,133,148,1145
2018-12-17,575,416,108,149,220,1468
2018-12-18,646,404,94,141,179,1464
2018-12-19,675,409,87,141,198,1510
2018-12-20,752,475,108,173,244,1752
2018-12-21,1152,659,114,205,367,2497
2018-12-22,1166,702,132,279,361,2640
2018-12-23,634,369,96,118,210,1427
2018-12-24,872,486,121,212,260,1951
2018-12-25,461,351,82,108,251,1253
2018-12-26,658,477,121,154,322,1732
2018-12-27,669,360,92,164,347,1632
2018-12-28,1012,476,120,230,371,2209
2018-12-29,984,395,147,239,349,2114
2018-12-30,549,257,116,158,294,1374
2018-12-31,613,338,95,191,204,1441
2019-01-01,439,229,62,139,99,968
2019-01-02,598,309,144,198,197,1446
2019-01-03,553,293,108,160,169,1283
2019-01-04,629,358,126,207,222,1542
2019-01-05,600,393,134,202,179,1508
2019-01-06,454,249,122,163,106,1094
2019-01-07,348,238,121,119,117,943
2019-01-08,569,377,111,165,192,1414
2019-01-09,477,308,66,130,149,1130
2019-01-10,454,309,111,120,136,1130
2019-01-11,650,474,113,124,205,1566
2019-01-12,829,435,110,179,219,1772
2019-01-13,361,188,48,99,107,803
2019-01-14,496,321,79,148,160,1204
2019-01-15,459,328,75,184,151,1197
2019-01-16,461,281,72,155,150,1119
2019-01-17,488,332,69,109,139,1137
2019-01-18,720,414,80,174,198,1586
2019-01-19,930,560,120,158,239,2007
2019-01-20,344,187,72,106,131,840
2019-01-21,538,292,82,149,182,1243
2019-01-22,445,261,93,132,111,1042
2019-01-23,470,274,86,129,135,1094
2019-01-24,384,208,75,94,131,892
2019-01-25,826,442,105,172,231,1776
2019-01-26,982,505,110,147,230,1974
2019-01-27,415,278,59,96,136,984
2019-01-28,529,321,78,117,208,1253
2019-01-29,505,344,77,119,145,1190
2019-01-30,572,261,77,123,146,1179
2019-01-31,506,330,79,134,155,1204
2019-02-01,784,459,95,126,248,1712
2019-02-02,903,599,108,165,242,2017
2019-02-03,398,250,65,96,106,915
2019-02-04,449,308,84,140,166,1147
2019-02-05,514,355,54,101,147,1171
2019-02-06,478,300,74,107,186,1145
2019-02-07,426,139,43,85,126,819
2019-02-08,709,459,99,154,213,1634
2019-02-09,934,625,118,155,233,2065
2019-02-10,367,270,55,85,117,894
2019-02-11,383,351,62,120,135,1051
2019-02-12,545,361,78,127,160,1271
2019-02-13,481,355,71,166,142,1215
2019-02-14,558,317,74,125,143,1217
2019-02-15,662,463,126,170,224,1645
2019-02-16,1042,504,89,169,267,2071
2019-02-17,354,260,70,80,130,894
2019-02-18,593,322,117,122,216,1370
2019-02-19,601,299,75,120,199,1294
2019-02-20,505,290,85,110,144,1134
2019-02-21,467,263,110,134,191,1165
2019-02-22,737,389,84,168,186,1564
2019-02-23,940,562,112,180,292,2086
2019-02-24,416,239,60,112,123,950
2019-02-25,459,373,96,128,151,1207
2019-02-26,520,288,83,99,139,1129
2019-02-27,470,312,67,156,148,1153
2019-02-28,496,333,76,158,181,1244
2019-03-01,726,496,92,159,190,1663
2019-03-02,930,593,119,122,252,2016
2019-03-03,454,236,71,123,137,1021
2019-03-04,518,344,76,115,160,1213
2019-03-05,522,298,63,113,150,1146
2019-03-06,470,338,63,121,186,1178
2019-03-07,433,315,64,127,180,1119
2019-03-08,707,447,89,154,206,1603
2019-03-09,1041,495,108,179,250,2073
2019-03-10,426,234,54,95,135,944
2019-03-11,557,307,75,136,204,1279
2019-03-12,456,300,69,120,160,1105
2019-03-13,514,321,72,134,137,1178
2019-03-14,548,324,75,119,153,1219
2019-03-15,776,490,84,157,206,1713
2019-03-16,1004,639,98,176,271,2188
2019-03-17,427,241,67,88,119,942
2019-03-18,460,349,88,140,175,1212
2019-03-19,473,355,84,114,158,1184
2019-03-20,461,394,89,129,162,1235
2019-03-21,536,382,68,122,169,1277
2019-03-22,758,443,106,130,224,1661
2019-03-23,890,547,125,186,226,1974
2019-03-24,602,326,77,138,148,1291
2019-03-25,402,273,82,99,110,966
2019-03-26,592,394,75,162,217,1440
2019-03-27,507,321,68,146,182,1224
2019-03-28,560,289,76,107,156,1188
2019-03-29,647,480,103,170,234,1634
2019-03-30,938,655,92,193,266,2144
2019-03-31,455,231,55,101,143,985
2019-04-01,562,346,89,152,165,1314
2019-04-02,602,343,104,143,222,1414
2019-04-03,508,358,88,141,185,1280
2019-04-04,509,394,84,116,147,1250
2019-04-05,845,597,98,134,200,1874
2019-04-06,1114,707,117,169,279,2386
2019-04-07,435,316,61,90,137,1039
2019-04-08,514,321,88,152,162,1237
2019-04-09,608,339,70,111,189,1317
2019-04-10,499,304,68,113,170,1154
2019-04-11,549,347,84,117,173,1270
2019-04-12,828,474,83,149,282,1816
2019-04-13,972,548,134,188,270,2112
2019-04-14,405,280,76,118,149,1028
2019-04-15,548,364,86,131,185,1314
2019-04-16,479,339,97,154,178,1247
2019-04-17,622,383,93,189,207,1494
2019-04-18,340,228,71,134,133,906
2019-04-19,284,153,80,111,98,726
2019-04-20,615,324,107,160,152,1358
2019-04-21,471,276,96,95,146,1084
2019-04-22,668,453,99,158,195,1573
2019-04-23,379,357,90,101,158,1085
2019-04-24,575,327,67,136,155,1260
2019-04-25,592,355,79,146,160,1332
2019-04-26,779,489,80,145,213,1706
2019-04-27,1016,602,113,184,270,2185
2019-04-28,359,227,40,125,126,877
2019-04-29,525,363,72,180,168,1308
2019-04-30,775,436,95,135,220,1661
2019-05-01,349,254,76,98,106,883
2019-05-02,619,385,101,148,161,1414
2019-05-03,738,428,97,148,262,1673
2019-05-04,1049,625,96,191,259,2220
2019-05-05,407,215,79,96,139,936
2019-05-06,518,304,69,147,186,1224
2019-05-07,601,339,94,143,160,1337
2019-05-08,571,315,62,136,198,1282
2019-05-09,562,341,83,130,210,1326
2019-05-10,874,480,107,179,208,1848
2019-05-11,1091,600,103,187,306,2287
2019-05-12,520,307,72,124,143,1166
2019-05-13,563,369,95,152,183,1362
2019-05-14,610,356,60,131,190,1347
2019-05-15,561,369,90,137,159,1316
2019-05-16,578,385,70,141,160,1334
2019-05-17,858,551,102,166,229,1906
2019-05-18,990,681,135,172,291,2269
2019-05-19,414,288,83,137,131,1053
2019-05-20,590,384,87,118,191,1370
2019-05-21,473,336,87,116,163,1175
2019-05-22,484,346,61,138,172,1201
2019-05-23,591,390,66,145,186,1378
2019-05-24,795,546,93,160,236,1830
2019-05-25,1033,633,117,163,237,2183
2019-05-26,477,251,72,108,140,1048
2019-05-27,398,277,68,136,132,1011
2019-05-28,524,385,98,168,197,1372
2019-05-29,587,353,83,168,177,1368
2019-05-30,623,403,88,148,183,1445
2019-05-31,840,567,105,205,263,1980
2019-06-01,1101,719,118,195,247,2380
2019-06-02,701,351,89,126,184,1451
2019-06-03,417,248,80,113,140,998
2019-06-04,614,458,110,185,196,1563
2019-06-05,505,309,97,147,172,1230
2019-06-06,613,363,89,119,185,1369
2019-06-07,925,505,126,165,234,1955
2019-06-08,975,639,120,182,310,2226
2019-06-09,479,260,79,83,126,1027
2019-06-10,548,380,100,152,194,1374
2019-06-11,532,334,84,151,161,1262
2019-06-12,585,371,78,141,161,1336
2019-06-13,606,365,103,138,190,1402
2019-06-14,855,506,114,172,283,1930
2019-06-15,1290,818,102,220,337,2767
2019-06-16,498,269,60,133,114,1074
2019-06-17,592,399,79,160,207,1437
2019-06-18,643,320,79,163,197,1402
2019-06-19,606,382,101,136,182,1407
2019-06-20,565,353,96,133,168,1315
2019-06-21,765,437,132,147,220,1701
2019-06-22,966,535,147,216,287,2151
2019-06-23,694,421,77,144,153,1489
2019-06-24,422,248,87,144,134,1035
2019-06-25,683,426,107,149,241,1606
2019-06-26,575,379,95,143,188,1380
2019-06-27,580,408,89,174,201,1452
2019-06-28,969,580,125,200,290,2164
2019-06-29,825,501,169,175,277,1947
2019-06-30,651,334,135,169,185,1474
2019-07-01,477,233,90,88,129,1017
2019-07-02,610,415,100,145,199,1469
2019-07-03,576,351,92,176,202,1397
2019-07-04,590,333,72,158,180,1333
2019-07-05,841,426,101,174,274,1816
2019-07-06,1009,599,119,181,314,2222
2019-07-07,480,260,52,125,138,1055
2019-07-08,511,387,72,125,194,1289
2019-07-09,581,324,77,140,199,1321
2019-07-10,565,339,98,125,195,1322
2019-07-11,681,360,75,115,205,1436
2019-07-12,874,603,98,172,271,2018
2019-07-13,1049,665,113,190,273,2290
2019-07-14,463,281,67,124,135,1070
2019-07-15,618,323,97,167,192,1397
2019-07-16,579,340,83,128,151,1281
2019-07-17,605,384,66,160,219,1434
2019-07-18,595,347,100,134,186,1362
2019-07-19,967,613,113,158,320,2171
2019-07-20,1034,550,87,146,277,2094
2019-07-21,497,244,78,109,142,1070
2019-07-22,598,391,70,153,223,1435
2019-07-23,575,381,60,134,173,1323
2019-07-24,490,328,64,150,205,1237
2019-07-25,535,345,83,125,190,1278
2019-07-26,794,490,104,131,246,1765
2019-07-27,1164,661,114,170,274,2383
2019-07-28,493,246,43,120,154,1056
2019-07-29,581,379,76,153,233,1422
2019-07-30,525,324,92,144,181,1266
2019-07-31,623,420,72,164,226,1505
2019-08-01,570,340,101,133,171,1315
2019-08-02,1015,571,125,154,253,2118
2019-08-03,1143,666,141,204,296,2450
2019-08-04,517,230,75,96,132,1050
2019-08-05,780,382,110,129,198,1599
2019-08-06,900,432,92,142,254,1820
2019-08-07,484,235,67,122,97,1005
2019-08-08,666,366,80,134,166,1412
2019-08-09,924,549,103,143,221,1940
2019-08-10,1127,593,100,183,286,2289
2019-08-11,470,308,64,120,119,1081
2019-08-12,580,359,95,155,182,1371
2019-08-13,531,390,64,117,200,1302
2019-08-14,547,357,64,160,163,1291
2019-08-15,702,372,68,169,202,1513
2019-08-16,968,459,97,139,198,1861
2019-08-17,1012,575,145,208,239,2179
2019-08-18,713,313,123,168,159,1476
2019-08-19,459,288,86,120,158,1111
2019-08-20,708,453,107,183,206,1657
2019-08-21,598,372,75,116,169,1330
2019-08-22,612,350,81,148,176,1367
2019-08-23,854,464,94,175,206,1793
2019-08-24,1184,654,118,158,317,2431
2019-08-25,442,231,57,116,145,991
2019-08-26,638,349,106,163,188,1444
2019-08-27,606,340,91,131,227,1395
2019-08-28,531,337,51,125,148,1192
2019-08-29,636,377,103,141,202,1459
2019-08-30,859,586,107,192,282,2026
2019-08-31,1203,661,124,181,320,2489
2019-09-01,460,304,54,138,129,1085
2019-09-02,623,377,67,131,203,1401
2019-09-03,615,357,94,157,176,1399
2019-09-04,580,333,70,129,196,1308
2019-09-05,647,351,94,137,196,1425
2019-09-06,910,476,124,171,273,1954
2019-09-07,1153,650,102,171,314,2390
2019-09-08,434,255,74,132,146,1041
2019-09-09,571,379,71,165,218,1404
2019-09-10,578,341,86,136,201,1342
2019-09-11,580,342,96,139,200,1357
2019-09-12,591,316,104,140,249,1400
2019-09-13,870,530,102,170,224,1896
2019-09-14,1124,710,121,215,282,2452
2019-09-15,451,297,81,141,143,1113
2019-09-16,623,352,79,193,201,1448
2019-09-17,627,390,96,154,173,1440
2019-09-18,617,346,86,155,198,1402
2019-09-19,637,366,92,134,206,1435
2019-09-20,917,532,99,209,300,2057
2019-09-21,1301,792,122,256,330,2801
2019-09-22,465,266,86,150,135,1102
2019-09-23,604,250,70,138,168,1230
2019-09-24,680,332,55,163,174,1404
2019-09-25,522,383,80,147,202,1334
2019-09-26,668,417,97,132,169,1483
2019-09-27,995,580,98,192,290,2155
2019-09-28,1208,745,117,252,302,2624
2019-09-29,492,279,63,148,131,1113
2019-09-30,671,390,96,180,201,1538
2019-10-01,620,361,89,128,203,1401
2019-10-02,570,371,83,148,159,1331
2019-10-03,578,431,88,172,187,1456
2019-10-04,1033,571,103,193,215,2115
2019-10-05,1207,694,128,201,292,2522
2019-10-06,381,294,63,134,143,1015
2019-10-07,581,378,110,151,164,1384
2019-10-08,514,404,89,143,188,1338
2019-10-09,588,388,107,141,172,1396
2019-10-10,595,344,106,102,194,1341
2019-10-11,724,509,122,187,245,1787
2019-10-12,995,519,164,223,254,2155
2019-10-13,720,389,110,156,173,1548
2019-10-14,480,305,71,94,160,1110
2019-10-15,731,470,130,142,213,1686
2019-10-16,588,352,93,191,188,1412
2019-10-17,631,366,80,145,213,1435
2019-10-18,939,547,96,181,273,2036
2019-10-19,1068,714,99,205,306,2392
2019-10-20,492,309,68,117,145,1131
2019-10-21,574,439,90,168,218,1489
2019-10-22,572,385,96,144,174,1371
2019-10-23,664,445,77,170,183,1539
2019-10-24,689,437,81,150,209,1566
2019-10-25,1066,616,117,194,233,2226
2019-10-26,905,640,94,193,239,2071
2019-10-27,519,269,58,115,122,1083
2019-10-28,606,421,78,132,175,1412
2019-10-29,618,424,70,171,196,1479
2019-10-30,578,418,67,135,176,1374
2019-10-31,723,513,72,177,188,1673
2019-11-01,860,531,94,158,241,1884
2019-11-02,1149,714,144,225,302,2534
2019-11-03,677,459,97,152,169,1554
2019-11-04,414,287,91,107,119,1018
2019-11-05,639,436,100,192,207,1574
2019-11-06,656,407,87,147,213,1510
2019-11-07,598,426,97,143,185,1449
2019-11-08,906,535,97,191,259,1988
2019-11-09,1033,626,135,239,320,2353
2019-11-10,715,413,94,173,193,1588
2019-11-11,462,307,80,121,112,1082
2019-11-12,750,506,106,160,235,1757
2019-11-13,600,490,89,153,219,1551
2019-11-14,638,432,98,148,182,1498
2019-11-15,977,654,115,169,213,2128
2019-11-16,1237,749,136,191,291,2604
2019-11-17,511,268,67,147,154,1147
2019-11-18,630,494,100,158,193,1575
2019-11-19,618,406,89,145,182,1440
2019-11-20,534,342,84,111,143,1214
2019-11-21,408,304,80,127,71,990
2019-11-22,1005,267,78,144,95,1589
2019-11-23,1249,481,146,236,206,2318
2019-11-24,595,220,65,123,140,1143
2019-11-25,722,422,98,144,234,1620
2019-11-26,625,385,73,167,216,1466
2019-11-27,528,256,110,174,145,1213
2019-11-28,707,385,99,155,199,1545
2019-11-29,1283,691,131,189,392,2686
2019-11-30,1446,850,176,269,397,3138
2019-12-01,561,323,74,108,168,1234
2019-12-02,651,477,101,190,250,1669
2019-12-03,611,465,83,144,223,1526
2019-12-04,676,355,70,131,146,1378
2019-12-05,926,527,93,174,272,1992
2019-12-06,1400,749,158,258,395,2960
2019-12-07,1460,853,129,227,303,2972
2019-12-08,605,328,103,175,169,1380
2019-12-09,735,477,89,163,197,1661
2019-12-10,697,449,80,158,239,1623
2019-12-11,700,467,107,137,253,1664
2019-12-12,907,485,92,165,250,1899
2019-12-13,1607,770,146,250,482,3255
2019-12-14,1634,854,207,220,405,3320
2019-12-15,625,343,92,134,159,1353
2019-12-16,708,458,108,185,193,1652
2019-12-17,660,491,98,177,195,1621
2019-12-18,793,472,75,173,265,1778
2019-12-19,955,578,125,168,246,2072
2019-12-20,1566,784,141,252,423,3166
2019-12-21,1451,865,155,254,402,3127
2019-12-22,730,373,99,159,225,1586
2019-12-23,1000,508,105,229,272,2114
2019-12-24,1067,610,111,234,268,2290
2019-12-25,587,335,61,145,291,1419
2019-12-26,801,454,124,203,350,1932
2019-12-27,1142,516,112,217,431,2418
2019-12-28,1173,466,145,253,432,2469
2019-12-29,531,305,90,174,306,1406
2019-12-30,770,349,147,219,358,1843
2019-12-31,655,302,134,184,209,1484
2020-01-01,394,214,83,124,108,923
2020-01-02,687,299,147,213,214,1560
2020-01-03,603,318,144,189,230,1484
2020-01-04,704,342,149,241,221,1657
2020-01-05,498,238,132,165,154,1187
2020-01-06,451,286,103,167,143,1150
2020-01-07,687,428,112,163,199,1589
2020-01-08,556,371,94,167,185,1373
2020-01-09,550,391,104,129,181,1355
2020-01-10,741,537,125,182,202,1787
2020-01-11,871,523,131,210,234,1969
2020-01-12,418,233,59,124,151,985
2020-01-13,596,386,74,153,194,1403
2020-01-14,495,314,74,146,174,1203
2020-01-15,581,329,92,109,207,1318
2020-01-16,531,288,74,127,171,1191
2020-01-17,809,457,75,147,227,1715
2020-01-18,1040,593,85,151,264,2133
2020-01-19,473,237,70,109,151,1040
2020-01-20,556,374,85,128,218,1361
2020-01-21,627,255,105,106,172,1265
2020-01-22,528,352,71,129,144,1224
2020-01-23,540,334,70,137,177,1258
2020-01-24,780,500,91,132,220,1723
2020-01-25,994,631,103,174,245,2147
2020-01-26,353,246,60,79,97,835
2020-01-27,626,467,91,146,157,1487
2020-01-28,554,387,72,128,155,1296
2020-01-29,538,337,93,134,151,1253
2020-01-30,513,315,85,126,171,1210
2020-01-31,982,518,113,189,223,2025
2020-02-01,1130,603,107,192,274,2306
2020-02-02,478,231,67,104,132,1012
2020-02-03,498,358,69,160,200,1285
2020-02-04,475,313,66,145,157,1156
2020-02-05,486,348,86,108,226,1254
2020-02-06,573,184,109,153,187,1206
2020-02-07,816,554,100,188,230,1888
2020-02-08,1074,646,132,227,258,2337
2020-02-09,506,338,69,99,126,1138
2020-02-10,552,338,77,158,160,1285
2020-02-11,502,358,71,124,172,1227
2020-02-12,481,368,69,114,134,1166
2020-02-13,604,414,66,126,185,1395
2020-02-14,781,465,85,148,212,1691
2020-02-15,1106,634,90,195,246,2271
2020-02-16,436,260,74,121,151,1042
2020-02-17,561,326,90,127,190,1294
2020-02-18,505,278,88,128,174,1173
2020-02-19,514,321,84,149,172,1240
2020-02-20,586,372,83,136,169,1346
2020-02-21,799,431,98,167,167,1662
2020-02-22,1109,625,103,168,260,2265
2020-02-23,508,264,66,124,159,1121
2020-02-24,537,324,71,171,173,1276
2020-02-25,565,382,95,125,139,1306
2020-02-26,525,358,66,152,149,1250
2020-02-27,568,324,75,143,149,1259
2020-02-28,772,521,100,162,235,1790
2020-02-29,1134,684,146,163,256,2383
2020-03-01,464,295,59,110,128,1056
2020-03-02,536,384,88,133,171,1312
2020-03-03,454,345,80,127,150,1156
2020-03-04,498,301,59,140,141,1139
2020-03-05,559,373,98,142,164,1336
2020-03-06,792,541,128,175,241,1877
2020-03-07,1087,561,128,176,291,2243
2020-03-08,399,224,82,107,154,966
2020-03-09,512,336,72,171,176,1267
2020-03-10,493,361,95,142,197,1288
2020-03-11,438,362,72,108,167,1147
2020-03-12,523,296,63,117,163,1162
2020-03-13,613,450,115,135,229,1542
2020-03-14,994,506,94,149,224,1967
2020-03-15,400,238,82,84,108,912
2020-03-16,432,351,88,115,152,1138
2020-03-17,345,257,68,82,107,859
2020-03-18,316,275,69,90,95,845
2020-03-19,317,248,55,99,102,821
2020-03-20,329,53,50,66,90,588
2020-03-21,76,38,25,19,10,168
2020-03-22,60,28,10,18,16,132
2020-03-23,55,41,13,25,16,150
2020-03-24,195,73,32,62,49,411
2020-03-25,72,57,27,31,25,212
2020-03-26,106,45,20,13,30,214
2020-03-27,106,60,23,32,30,251
2020-03-28,122,34,22,16,38,232
2020-03-29,49,28,6,10,19,112
2020-03-30,146,93,18,23,56,336
2020-03-31,113,81,25,21,53,293
2020-04-01,159,81,36,28,64,368
2020-04-02,133,80,28,35,51,327
2020-04-03,146,88,23,38,44,339
2020-04-04,147,66,20,26,47,306
2020-04-05,83,31,8,16,27,165
2020-04-06,196,93,26,42,63,420
2020-04-07,219,108,23,38,54,442
2020-04-08,182,87,24,40,68,401
2020-04-09,70,52,25,25,32,204
2020-04-10,52,25,12,8,14,111
2020-04-11,169,78,16,28,60,351
2020-04-12,67,60,19,11,16,173
2020-04-13,192,159,49,47,88,535
2020-04-14,200,124,39,37,75,475
2020-04-15,205,135,38,60,90,528
2020-04-16,245,113,42,39,54,493
2020-04-17,234,140,32,35,78,519
2020-04-18,194,93,23,39,73,422
2020-04-19,118,90,15,18,40,281
2020-04-20,257,150,48,52,63,570
2020-04-21,212,152,46,55,66,531
2020-04-22,219,113,31,50,56,469
2020-04-23,179,160,28,55,51,473
2020-04-24,244,194,59,61,89,647
2020-04-25,234,154,31,12,63,494
2020-04-26,147,75,24,29,24,299
2020-04-27,285,203,56,59,106,709
2020-04-28,279,178,41,62,97,657
2020-04-29,272,167,41,63,103,646
2020-04-30,305,172,42,56,80,655
2020-05-01,192,105,32,23,30,382
2020-05-02,261,165,31,38,88,583
2020-05-03,175,91,17,14,48,345
2020-05-04,287,218,64,49,97,715
2020-05-05,260,211,57,69,79,676
2020-05-06,279,214,37,86,84,700
2020-05-07,270,218,45,65,87,685
2020-05-08,290,184,44,71,106,695
2020-05-09,283,160,22,53,82,600
2020-05-10,155,87,4,26,60,332
2020-05-11,395,283,52,94,114,938
2020-05-12,358,215,60,84,88,805
2020-05-13,323,226,49,73,106,777
2020-05-14,316,168,56,76,120,736
2020-05-15,345,197,72,57,104,775
2020-05-16,285,208,36,47,76,652
2020-05-17,179,91,24,26,58,378
2020-05-18,388,231,74,96,119,908
2020-05-19,289,206,55,86,81,717
2020-05-20,277,222,51,101,96,747
2020-05-21,310,221,45,70,119,765
2020-05-22,291,243,60,54,91,739
2020-05-23,275,214,34,46,112,681
2020-05-24,174,93,22,32,51,372
2020-05-25,146,114,22,32,53,367
2020-05-26,378,289,66,94,101,928
2020-05-27,311,189,53,94,103,750
2020-05-28,322,228,66,84,111,811
2020-05-29,302,292,58,94,88,834
2020-05-30,292,204,41,73,102,712
2020-05-31,178,126,25,26,50,405
2020-06-01,411,207,70,107,111,906
2020-06-02,343,191,66,74,107,781
2020-06-03,369,227,61,71,129,857
2020-06-04,375,267,41,71,121,875
2020-06-05,406,231,46,102,108,893
2020-06-06,349,227,47,56,92,771
2020-06-07,166,127,22,36,63,414
2020-06-08,365,246,54,103,146,914
2020-06-09,373,286,61,108,77,905
2020-06-10,347,255,35,84,112,833
2020-06-11,312,225,66,96,111,810
2020-06-12,345,270,54,90,86,845
2020-06-13,349,220,61,46,99,775
2020-06-14,138,86,23,20,32,299
2020-06-15,198,122,38,26,67,451
2020-06-16,463,291,61,78,128,1021
2020-06-17,350,210,39,92,112,803
2020-06-18,372,230,51,90,113,856
2020-06-19,441,230,81,108,116,976
2020-06-20,342,210,72,58,102,784
2020-06-21,146,71,27,21,45,310
2020-06-22,191,143,28,27,56,445
2020-06-23,442,246,74,116,127,1005
2020-06-24,382,240,65,71,107,865
2020-06-25,341,245,60,103,112,861
2020-06-26,416,248,62,58,109,893
2020-06-27,368,240,57,63,116,844
2020-06-28,232,119,30,24,47,452
2020-06-29,244,153,28,33,62,520
2020-06-30,381,234,47,88,136,886
2020-07-01,402,244,56,104,112,918
2020-07-02,417,267,43,78,93,898
2020-07-03,399,281,52,71,108,911
2020-07-04,417,247,48,59,79,850
2020-07-05,233,140,26,30,74,503
2020-07-06,425,237,78,101,105,946
2020-07-07,288,259,58,99,122,826
2020-07-08,404,233,67,84,131,919
2020-07-09,392,234,57,81,103,867
2020-07-10,367,245,58,78,116,864
2020-07-11,379,250,70,62,93,854
2020-07-12,206,115,39,33,67,460
2020-07-13,380,216,64,85,112,857
2020-07-14,396,191,68,70,117,842
2020-07-15,327,208,63,75,92,765
2020-07-16,352,179,64,70,87,752
2020-07-17,161,183,48,100,123,615
2020-07-18,130,177,42,63,64,476
2020-07-19,57,89,20,23,39,228
2020-07-20,103,98,20,41,43,305
2020-07-21,464,201,60,120,130,975
2020-07-22,331,212,49,84,103,779
2020-07-23,395,164,49,90,124,822
2020-07-24,192,190,61,69,134,646
2020-07-25,147,172,42,74,115,550
2020-07-26,119,100,29,41,57,346
2020-07-27,539,218,61,93,143,1054
2020-07-28,409,198,47,80,117,851
2020-07-29,347,207,68,102,95,819
2020-07-30,381,197,55,81,112,826
2020-07-31,190,194,65,92,99,640
2020-08-01,153,161,43,80,109,546
2020-08-02,122,79,24,34,54,313
2020-08-03,400,166,61,104,106,837
2020-08-04,388,168,72,89,116,833
2020-08-05,377,186,65,68,118,814
2020-08-06,460,197,83,93,96,929
2020-08-07,103,111,40,42,63,359
2020-08-08,184,173,30,80,98,565
2020-08-09,157,106,26,29,68,386
2020-08-10,480,259,56,97,123,1015
2020-08-11,378,189,65,88,115,835
2020-08-12,444,217,39,82,97,879
2020-08-13,452,191,56,92,107,898
2020-08-14,426,214,71,93,112,916
2020-08-15,170,233,52,87,109,651
2020-08-16,113,102,23,38,67,343
2020-08-17,135,111,40,48,56,390
2020-08-18,516,254,77,98,131,1076
2020-08-19,377,200,57,85,111,830
2020-08-20,412,209,57,92,126,896
2020-08-21,414,211,69,112,122,928
2020-08-22,403,210,62,76,98,849
2020-08-23,219,92,53,47,56,467
2020-08-24,427,278,55,127,88,975
2020-08-25,396,225,58,86,104,869
2020-08-26,413,229,47,81,95,865
2020-08-27,89,66,11,27,26,219
2020-08-28,392,227,81,102,129,931
2020-08-29,348,310,68,104,85,915
2020-08-30,265,136,47,44,83,575
2020-08-31,482,314,92,129,127,1144
2020-09-01,412,267,65,99,132,975
2020-09-02,385,269,53,75,113,895
2020-09-03,375,254,85,85,122,921
2020-09-04,566,331,76,134,122,1229
2020-09-05,649,315,86,96,113,1259
2020-09-06,351,168,55,65,84,723
2020-09-07,393,281,75,101,143,993
2020-09-08,379,283,82,85,125,954
2020-09-09,368,237,71,89,104,869
2020-09-10,447,197,82,95,127,948
2020-09-11,487,242,83,83,132,1027
2020-09-12,646,295,76,113,160,1290
2020-09-13,329,200,73,52,80,734
2020-09-14,468,300,82,114,166,1130
2020-09-15,445,279,70,80,149,1023
2020-09-16,363,284,71,87,133,938
2020-09-17,425,253,57,79,128,942
2020-09-18,513,241,57,93,156,1060
2020-09-19,780,405,97,150,203,1635
2020-09-20,364,227,55,86,90,822
2020-09-21,477,227,68,122,114,1008
2020-09-22,467,274,76,118,141,1076
2020-09-23,459,271,80,131,109,1050
2020-09-24,427,197,65,104,118,911
2020-09-25,716,376,72,148,136,1448
2020-09-26,734,459,86,136,176,1591
2020-09-27,338,161,35,54,96,684
2020-09-28,489,259,71,114,154,1087
2020-09-29,471,291,71,112,129,1074
2020-09-30,508,272,91,119,120,1110
2020-10-01,457,292,70,101,131,1051
2020-10-02,608,361,90,118,137,1314
2020-10-03,711,373,94,157,144,1479
2020-10-04,329,212,55,71,93,760
2020-10-05,457,331,79,150,155,1172
2020-10-06,406,254,64,134,131,989
2020-10-07,387,269,53,108,145,962
2020-10-08,408,268,78,111,142,1007
2020-10-09,622,374,94,150,195,1435
2020-10-10,645,342,87,129,200,1403
2020-10-11,481,226,94,123,126,1050
2020-10-12,416,217,75,70,99,877
2020-10-13,623,329,76,135,139,1302
2020-10-14,469,240,72,103,147,1031
2020-10-15,435,236,64,123,140,998
2020-10-16,591,328,65,123,168,1275
2020-10-17,712,379,88,142,159,1480
2020-10-18,368,221,76,114,113,892
2020-10-19,442,263,62,93,151,1011
2020-10-20,440,249,75,88,143,995
2020-10-21,425,235,78,93,140,971
2020-10-22,456,275,65,99,142,1037
2020-10-23,652,303,60,99,149,1263
2020-10-24,692,378,74,122,132,1398
2020-10-25,356,166,69,117,85,793
2020-10-26,490,256,58,129,133,1066
2020-10-27,400,252,43,108,99,902
2020-10-28,429,290,63,117,130,1029
2020-10-29,497,264,70,113,137,1081
2020-10-30,484,359,68,137,163,1211
2020-10-31,441,395,94,172,165,1267
2020-11-01,295,247,47,133,106,828
2020-11-02,334,225,44,90,100,793
2020-11-03,505,355,85,138,143,1226
2020-11-04,431,251,67,99,107,955
2020-11-05,493,255,51,98,95,992
2020-11-06,579,346,71,106,142,1244
2020-11-07,664,351,82,115,142,1354
2020-11-08,386,194,57,78,97,812
2020-11-09,597,309,85,130,159,1280
2020-11-10,418,250,75,109,103,955
2020-11-11,395,305,82,108,106,996
2020-11-12,469,300,58,88,137,1052
2020-11-13,522,371,78,153,163,1287
2020-11-14,654,374,76,205,168,1477
2020-11-15,491,251,77,136,134,1089
2020-11-16,441,207,59,95,89,891
2020-11-17,599,362,72,174,142,1349
2020-11-18,506,275,67,159,132,1139
2020-11-19,510,278,81,140,104,1113
2020-11-20,699,343,74,136,188,1440
2020-11-21,823,415,102,129,161,1630
2020-11-22,408,213,73,93,103,890
2020-11-23,582,259,81,166,138,1226
2020-11-24,520,314,72,125,121,1152
2020-11-25,509,282,68,119,132,1110
2020-11-26,600,316,77,130,126,1249
2020-11-27,750,398,111,110,159,1528
2020-11-28,939,508,85,160,165,1857
2020-11-29,489,274,70,127,101,1061
2020-11-30,677,364,85,135,139,1400
2020-12-01,590,291,74,125,108,1188
2020-12-02,491,266,69,118,121,1065
2020-12-03,539,279,95,111,173,1197
2020-12-04,795,398,129,112,153,1587
2020-12-05,918,427,130,138,159,1772
2020-12-06,448,238,95,111,121,1013
2020-12-07,827,411,97,170,172,1677
2020-12-08,503,215,69,80,97,964
2020-12-09,618,313,90,142,158,1321
2020-12-10,592,294,86,93,124,1189
2020-12-11,841,403,89,136,173,1642
2020-12-12,884,407,95,143,163,1692
2020-12-13,457,262,88,85,94,986
2020-12-14,554,339,85,141,149,1268
2020-12-15,483,331,86,117,146,1163
2020-12-16,536,325,75,109,130,1175
2020-12-17,585,282,58,101,138,1164
2020-12-18,788,441,119,135,185,1668
2020-12-19,936,456,96,192,151,1831
2020-12-20,519,283,88,73,108,1071
2020-12-21,683,402,87,124,164,1460
2020-12-22,563,377,76,129,113,1258
2020-12-23,582,354,98,146,150,1330
2020-12-24,526,362,69,101,143,1201
2020-12-25,133,204,39,58,87,521
2020-12-26,655,268,121,145,179,1368
2020-12-27,457,200,74,86,109,926
2020-12-28,654,300,99,146,182,1381
2020-12-29,478,280,116,136,139,1149
2020-12-30,548,321,125,128,147,1269
2020-12-31,378,219,76,106,103,882
2021-01-01,57,117,45,66,23,308
2021-01-02,165,178,115,92,65,615
2021-01-03,454,177,114,104,102,951
2021-01-04,553,303,93,147,149,1245
2021-01-05,421,229,74,111,117,952
2021-01-06,381,231,89,107,124,932
2021-01-07,377,176,79,109,105,846
2021-01-08,473,139,59,124,112,907
2021-01-09,157,99,84,91,59,490
2021-01-10,81,105,67,65,22,340
2021-01-11,182,111,28,76,57,454
2021-01-12,672,258,81,140,128,1279
2021-01-13,492,220,53,96,144,1005
2021-01-14,423,221,109,112,116,981
2021-01-15,516,225,81,105,69,996
2021-01-16,247,142,67,88,53,597
2021-01-17,145,103,49,86,44,427
2021-01-18,558,305,109,101,155,1228
2021-01-19,461,215,64,109,115,964
2021-01-20,389,262,62,87,119,919
2021-01-21,409,231,75,90,150,955
2021-01-22,488,260,71,134,114,1067
2021-01-23,559,131,82,102,98,972
2021-01-24,350,81,70,92,75,668
2021-01-25,476,289,93,125,141,1124
2021-01-26,437,257,59,108,121,982
2021-01-27,456,221,67,100,136,980
2021-01-28,458,212,49,98,102,919
2021-01-29,635,282,63,96,149,1225
2021-01-30,692,261,78,141,118,1290
2021-01-31,412,161,73,74,75,795
2021-02-01,511,248,84,101,119,1063
2021-02-02,484,230,55,107,103,979
2021-02-03,434,208,67,104,135,948
2021-02-04,429,231,57,94,101,912
2021-02-05,644,320,90,158,143,1355
2021-02-06,721,349,80,126,138,1414
2021-02-07,424,205,63,82,100,874
2021-02-08,488,242,71,121,123,1045
2021-02-09,459,273,70,114,112,1028
2021-02-10,432,255,69,78,102,936
2021-02-11,498,244,70,86,115,1013
2021-02-12,695,291,88,105,148,1327
2021-02-13,843,376,83,97,134,1533
2021-02-14,425,211,52,74,83,845
2021-02-15,430,268,51,111,131,991
2021-02-16,500,257,69,98,139,1063
2021-02-17,466,187,64,101,115,933
2021-02-18,443,232,52,101,115,943
2021-02-19,651,328,77,105,150,1311
2021-02-20,815,391,85,110,176,1577
2021-02-21,381,196,44,84,112,817
2021-02-22,491,304,84,125,170,1174
2021-02-23,412,232,62,132,124,962
2021-02-24,435,204,90,135,147,1011
2021-02-25,483,283,65,110,144,1085
2021-02-26,735,353,94,129,157,1468
2021-02-27,872,401,103,133,192,1701
2021-02-28,399,201,47,110,104,861
2021-03-01,468,276,90,107,153,1094
2021-03-02,446,250,47,85,139,967
2021-03-03,367,232,73,107,134,913
2021-03-04,448,211,71,98,112,940
2021-03-05,669,363,84,124,155,1395
2021-03-06,861,408,99,132,202,1702
2021-03-07,413,210,55,94,87,859
2021-03-08,494,248,74,134,162,1112
2021-03-09,459,274,58,75,151,1017
2021-03-10,440,226,76,103,122,967
2021-03-11,501,245,71,95,152,1064
2021-03-12,750,337,94,110,171,1462
2021-03-13,902,402,116,132,187,1739
2021-03-14,351,233,68,91,79,822
2021-03-15,532,286,85,119,128,1150
2021-03-16,491,237,81,101,126,1036
2021-03-17,468,219,67,91,122,967
2021-03-18,573,228,70,102,137,1110
2021-03-19,781,402,84,159,193,1619
2021-03-20,829,375,130,139,187,1660
2021-03-21,579,277,66,104,140,1166
2021-03-22,385,191,60,99,104,839
2021-03-23,592,283,103,119,191,1288
2021-03-24,550,270,50,103,135,1108
2021-03-25,490,236,72,95,124,1017
2021-03-26,590,305,94,118,146,1253
2021-03-27,631,329,75,103,150,1288
2021-03-28,294,168,72,88,80,702
2021-03-29,495,288,75,84,183,1125
2021-03-30,489,221,78,130,132,1050
2021-03-31,546,243,100,118,152,1159
2021-04-01,226,165,52,79,78,600
2021-04-02,214,111,76,50,77,528
2021-04-03,360,260,117,117,124,978
2021-04-04,292,184,79,61,80,696
2021-04-05,529,297,117,115,170,1228
2021-04-06,397,263,66,110,119,955
2021-04-07,367,232,53,83,108,843
2021-04-08,429,229,72,99,108,937
2021-04-09,205,272,91,96,115,779
2021-04-10,162,141,57,76,96,532
2021-04-11,125,48,50,42,81,346
2021-04-12,513,151,74,112,141,991
2021-04-13,394,279,68,80,128,949
2021-04-14,355,269,57,71,94,846
2021-04-15,480,207,61,106,114,968
2021-04-16,251,113,47,116,127,654
2021-04-17,177,98,57,86,77,495
2021-04-18,125,93,38,41,43,340
2021-04-19,524,261,75,128,139,1127
2021-04-20,396,266,76,76,133,947
2021-04-21,359,222,66,82,101,830
2021-04-22,397,260,55,105,123,940
2021-04-23,260,131,59,93,69,612
2021-04-24,213,139,72,65,57,546
2021-04-25,154,88,57,65,49,413
2021-04-26,563,303,52,114,137,1169
2021-04-27,463,237,72,75,161,1008
2021-04-28,383,165,55,92,42,737
2021-04-29,478,296,52,75,49,950
2021-04-30,239,190,68,105,51,653
2021-05-01,151,114,37,39,25,366
2021-05-02,165,90,39,50,46,390
2021-05-03,567,230,56,106,76,1035
2021-05-04,460,236,52,79,53,880
2021-05-05,381,146,49,96,63,735
2021-05-06,423,166,51,88,53,781
2021-05-07,462,183,37,93,73,848
2021-05-08,233,193,41,73,41,581
2021-05-09,168,120,43,33,37,401
2021-05-10,503,273,76,97,73,1022
2021-05-11,431,274,50,98,59,912
2021-05-12,317,170,40,83,61,671
2021-05-13,479,191,43,96,96,905
2021-05-14,473,221,63,98,112,967
2021-05-15,660,280,64,105,82,1191
2021-05-16,474,197,72,62,43,848
2021-05-17,391,171,48,64,74,748
2021-05-18,645,269,83,114,104,1215
2021-05-19,370,142,61,71,54,698
2021-05-20,506,223,71,79,121,1000
2021-05-21,512,266,66,125,111,1080
2021-05-22,628,287,86,135,94,1230
2021-05-23,375,187,69,64,57,752
2021-05-24,524,230,71,104,97,1026
2021-05-25,553,243,61,123,99,1079
2021-05-26,493,201,66,93,93,946
2021-05-27,528,222,64,77,95,986
2021-05-28,562,245,59,79,71,1016
2021-05-29,647,310,68,150,88,1263
2021-05-30,423,194,55,72,63,807
2021-05-31,518,265,64,134,98,1079
2021-06-01,506,256,52,103,114,1031
2021-06-02,449,238,68,92,106,953
2021-06-03,498,258,82,123,142,1103
2021-06-04,590,324,80,110,131,1235
2021-06-05,548,322,107,135,154,1266
2021-06-06,406,230,65,86,98,885
2021-06-07,372,183,67,109,91,822
2021-06-08,644,322,109,137,133,1345
2021-06-09,551,242,63,96,116,1068
2021-06-10,540,279,80,123,105,1127
2021-06-11,738,355,83,104,125,1405
2021-06-12,901,356,108,166,163,1694
2021-06-13,580,219,51,81,102,1033
2021-06-14,405,204,57,87,91,844
2021-06-15,643,342,97,122,192,1396
2021-06-16,508,283,90,101,138,1120
2021-06-17,542,264,72,133,128,1139
2021-06-18,823,329,95,106,158,1511
2021-06-19,920,357,104,133,153,1667
2021-06-20,453,242,66,73,70,904
2021-06-21,541,298,98,105,148,1190
2021-06-22,461,216,115,114,119,1025
2021-06-23,536,268,73,97,146,1120
2021-06-24,536,234,87,110,101,1068
2021-06-25,683,304,70,119,165,1341
2021-06-26,728,327,89,114,160,1418
2021-06-27,315,154,78,65,78,690
2021-06-28,443,283,70,103,114,1013
2021-06-29,542,266,59,103,147,1117
2021-06-30,490,277,69,103,122,1061
2021-07-01,528,250,87,110,133,1108
2021-07-02,670,330,120,158,179,1457
2021-07-03,760,325,79,119,158,1441
2021-07-04,453,185,75,98,98,909
2021-07-05,343,181,66,101,95,786
2021-07-06,677,319,72,142,158,1368
2021-07-07,505,255,74,121,107,1062
2021-07-08,530,293,89,107,122,1141
2021-07-09,663,344,86,129,152,1374
2021-07-10,861,326,85,124,141,1537
2021-07-11,341,173,58,46,58,676
2021-07-12,649,318,77,151,134,1329
2021-07-13,525,259,87,139,104,1114
2021-07-14,432,234,83,117,107,973
2021-07-15,500,248,75,123,126,1072
2021-07-16,714,322,115,129,148,1428
2021-07-17,912,376,95,153,129,1665
2021-07-18,397,167,81,111,105,861
2021-07-19,687,292,88,162,144,1373
2021-07-20,321,138,39,86,57,641
2021-07-21,628,259,97,129,120,1233
2021-07-22,574,243,79,139,119,1154
2021-07-23,710,283,80,112,126,1311
2021-07-24,855,388,106,141,166,1656
2021-07-25,411,178,65,69,104,827
2021-07-26,405,173,39,83,74,774
2021-07-27,248,86,19,48,53,454
2021-07-28,537,269,85,103,126,1120
2021-07-29,516,323,88,126,150,1203
2021-07-30,949,388,86,158,155,1736
2021-07-31,1025,414,106,171,166,1882
2021-08-01,386,205,58,103,104,856
2021-08-02,637,255,88,140,137,1257
2021-08-03,580,240,79,92,121,1112
2021-08-04,516,269,102,119,137,1143
2021-08-05,525,243,75,131,124,1098
2021-08-06,908,305,98,148,146,1605
2021-08-07,741,355,107,138,154,1495
2021-08-08,404,257,63,99,96,919
2021-08-09,643,298,83,126,163,1313
2021-08-10,567,292,75,119,111,1164
2021-08-11,559,266,77,102,134,1138
2021-08-12,569,267,88,114,136,1174
2021-08-13,915,350,91,143,174,1673
2021-08-14,940,415,114,163,181,1813
2021-08-15,693,276,79,113,128,1289
2021-08-16,431,273,91,75,92,962
2021-08-17,649,302,93,144,136,1324
2021-08-18,570,299,90,123,119,1201
2021-08-19,539,272,71,131,112,1125
2021-08-20,827,411,91,165,195,1689
2021-08-21,1003,452,133,167,190,1945
2021-08-22,385,184,61,82,113,825
2021-08-23,609,304,77,123,144,1257
2021-08-24,542,301,73,128,144,1188
2021-08-25,450,257,67,96,109,979
2021-08-26,547,201,88,134,111,1081
2021-08-27,893,337,76,165,178,1649
2021-08-28,947,402,77,143,178,1747
2021-08-29,395,211,75,100,122,903
2021-08-30,665,281,93,124,154,1317
2021-08-31,665,232,63,108,137,1205
2021-09-01,504,226,77,132,100,1039
2021-09-02,598,285,75,112,114,1184
2021-09-03,832,384,84,152,166,1618
2021-09-04,894,452,93,158,204,1801
2021-09-05,425,195,63,102,98,883
2021-09-06,575,298,68,146,176,1263
2021-09-07,468,304,67,122,111,1072
2021-09-08,447,294,86,114,137,1078
2021-09-09,523,247,62,117,120,1069
2021-09-10,753,392,66,156,169,1536
2021-09-11,903,480,113,153,232,1881
2021-09-12,416,232,60,105,95,908
2021-09-13,563,286,96,134,159,1238
2021-09-14,559,229,80,110,106,1084
2021-09-15,552,245,60,105,123,1085
2021-09-16,580,259,58,99,148,1144
2021-09-17,942,399,94,172,242,1849
2021-09-18,1173,492,111,209,189,2174
2021-09-19,483,221,44,127,97,972
2021-09-20,562,301,83,136,156,1238
2021-09-21,470,279,83,119,131,1082
2021-09-22,571,265,63,95,114,1108
2021-09-23,575,285,47,112,131,1150
2021-09-24,841,390,106,160,170,1667
2021-09-25,1029,500,113,171,213,2026
2021-09-26,449,214,71,98,94,926
2021-09-27,632,268,81,121,150,1252
2021-09-28,492,227,60,124,103,1006
2021-09-29,520,240,72,122,136,1090
2021-09-30,607,298,68,112,125,1210
2021-10-01,833,394,120,125,190,1662
2021-10-02,1027,473,96,170,189,1955
2021-10-03,414,227,68,87,102,898
2021-10-04,526,272,66,121,126,1111
2021-10-05,496,278,76,121,142,1113
2021-10-06,510,277,73,113,131,1104
2021-10-07,576,302,82,113,132,1205
2021-10-08,724,383,104,134,164,1509
2021-10-09,940,445,115,167,199,1866
2021-10-10,452,249,75,97,99,972
2021-10-11,514,305,84,139,152,1194
2021-10-12,520,291,57,119,134,1121
2021-10-13,491,285,83,132,186,1177
2021-10-14,495,276,83,131,128,1113
2021-10-15,778,319,131,161,184,1573
2021-10-16,857,402,104,192,160,1715
2021-10-17,626,271,102,112,123,1234
2021-10-18,466,179,73,112,140,970
2021-10-19,701,328,103,170,147,1449
2021-10-20,508,309,75,126,124,1142
2021-10-21,488,312,67,110,104,1081
2021-10-22,889,352,72,180,151,1644
2021-10-23,963,535,107,176,208,1989
2021-10-24,418,215,85,87,109,914
2021-10-25,576,369,87,133,151,1316
2021-10-26,534,346,76,105,125,1186
2021-10-27,637,292,71,139,130,1269
2021-10-28,645,315,95,136,168,1359
2021-10-29,922,459,77,170,165,1793
2021-10-30,1055,524,106,166,209,2060
2021-10-31,736,322,73,135,164,1430
2021-11-01,448,251,62,106,103,970
2021-11-02,678,348,107,149,168,1450
2021-11-03,607,306,81,127,133,1254
2021-11-04,531,346,73,145,124,1219
2021-11-05,746,438,94,158,142,1578
2021-11-06,997,523,127,140,211,1998
2021-11-07,376,222,38,101,71,808
2021-11-08,601,318,85,146,150,1300
2021-11-09,559,281,71,130,125,1166
2021-11-10,633,323,73,112,107,1248
2021-11-11,654,358,82,121,142,1357
2021-11-12,903,423,90,141,145,1702
2021-11-13,1036,470,134,162,178,1980
2021-11-14,673,312,77,169,126,1357
2021-11-15,447,216,72,105,104,944
2021-11-16,731,358,97,134,162,1482
2021-11-17,621,359,98,134,133,1345
2021-11-18,667,311,82,116,144,1320
2021-11-19,938,385,95,175,161,1754
2021-11-20,941,509,99,174,173,1896
2021-11-21,487,228,80,75,81,951
2021-11-22,609,260,77,151,136,1233
2021-11-23,620,302,97,110,150,1279
2021-11-24,633,254,67,116,113,1183
2021-11-25,662,339,90,120,139,1350
2021-11-26,1029,483,85,135,186,1918
2021-11-27,1108,534,93,181,235,2151
2021-11-28,486,190,56,115,122,969
2021-11-29,614,355,94,156,172,1391
2021-11-30,707,302,86,147,142,1384
2021-12-01,641,316,98,114,111,1280
2021-12-02,780,343,84,117,167,1491
2021-12-03,1069,467,124,161,216,2037
2021-12-04,1106,523,137,173,206,2145
2021-12-05,499,250,83,96,98,1026
2021-12-06,727,314,98,160,177,1476
2021-12-07,991,482,89,180,162,1904
2021-12-08,479,248,72,117,87,1003
2021-12-09,836,396,107,161,145,1645
2021-12-10,1124,512,112,161,222,2131
2021-12-11,1064,503,120,173,212,2072
2021-12-12,466,213,79,103,122,983
2021-12-13,777,385,92,142,153,1549
2021-12-14,687,325,69,117,185,1383
2021-12-15,738,327,77,133,163,1438
2021-12-16,751,374,86,171,164,1546
2021-12-17,1136,556,112,187,251,2242
2021-12-18,1138,464,144,184,261,2191
2021-12-19,591,273,79,103,114,1160
2021-12-20,892,378,91,135,171,1667
2021-12-21,724,396,89,150,202,1561
2021-12-22,885,345,88,142,198,1658
2021-12-23,898,443,119,173,195,1828
2021-12-24,815,319,73,180,128,1515
2021-12-25,475,216,61,95,155,1002
2021-12-26,506,216,101,130,177,1130
2021-12-27,797,355,93,173,262,1680
2021-12-28,654,301,83,166,210,1414
2021-12-29,637,312,106,119,216,1390
2021-12-30,725,321,105,164,184,1499
2021-12-31,525,209,113,155,129,1131
2022-01-01,348,118,75,93,56,690
2022-01-02,407,152,101,101,83,844
2022-01-03,606,289,127,171,131,1324
2022-01-04,492,205,103,148,119,1067
2022-01-05,428,254,86,125,115,1008
2022-01-06,470,260,121,122,114,1087
2022-01-07,589,318,109,132,118,1266
2022-01-08,628,271,110,151,140,1300
2022-01-09,428,175,78,150,88,919
2022-01-10,346,172,88,95,81,782
2022-01-11,664,314,99,152,151,1380
2022-01-12,561,283,107,101,136,1188
2022-01-13,527,255,74,93,147,1096
2022-01-14,712,323,94,122,178,1429
2022-01-15,772,408,87,108,160,1535
2022-01-16,448,179,60,88,102,877
2022-01-17,580,270,82,104,165,1201
2022-01-18,537,240,82,96,135,1090
2022-01-19,535,243,78,122,111,1089
2022-01-20,559,224,65,112,129,1089
2022-01-21,677,332,68,156,172,1405
2022-01-22,861,404,82,146,173,1666
2022-01-23,417,176,48,83,84,808
2022-01-24,621,327,74,97,153,1272
2022-01-25,543,265,88,114,164,1174
2022-01-26,482,224,75,112,110,1003
2022-01-27,541,267,72,105,138,1123
2022-01-28,729,322,88,148,126,1413
2022-01-29,879,419,89,135,214,1736
2022-01-30,448,206,58,72,87,871
2022-01-31,663,285,87,137,132,1304
2022-02-01,573,261,79,122,150,1185
2022-02-02,519,244,93,93,134,1083
2022-02-03,583,285,66,95,138,1167
2022-02-04,754,334,89,122,162,1461
2022-02-05,1000,394,114,134,159,1801
2022-02-06,434,215,63,67,73,852
2022-02-07,563,314,83,115,140,1215
2022-02-08,537,298,77,115,144,1171
2022-02-09,532,248,72,133,115,1100
2022-02-10,524,267,82,101,144,1118
2022-02-11,720,379,90,141,158,1488
2022-02-12,981,481,104,146,181,1893
2022-02-13,462,170,47,85,79,843
2022-02-14,589,314,66,112,129,1210
2022-02-15,565,264,54,109,100,1092
2022-02-16,536,279,83,97,128,1123
2022-02-17,571,248,63,105,130,1117
2022-02-18,823,354,107,150,160,1594
2022-02-19,897,479,76,136,215,1803
2022-02-20,439,221,61,90,107,918
2022-02-21,644,300,76,143,169,1332
2022-02-22,537,273,89,126,119,1144
2022-02-23,503,237,63,105,121,1029
2022-02-24,557,232,81,92,144,1106
2022-02-25,819,415,99,114,159,1606
2022-02-26,987,461,95,151,191,1885
2022-02-27,435,170,67,84,88,844
2022-02-28,696,349,97,87,147,1376
